1111111111111
1P00000C100E1
1001111110001
1000C00000001
1111111111111
