1111111111111111111111111111
11111111110C1111000100E11111
1111111110011111001100011111
1111111100111111011100011111
11111110011111111110C0111111
1111110011111111110001111111
1111100111111111100011111111
1111000000001111000111011111
1111P00000C00000000110011111
111111111000111100C100011111
1111111110001111111111111111
1111111111111111111111111111
