1111111111111111111111111111111111
1000000C00000000000001000000E00001
101P010100100000101001000000010101
1010010010101010001001000C00010101
100000000000100000C001000000000001
1111111111111111111111111111111111
