11111111111111111111111111111111
1111111111111111C0000011111111C1
1P001000000C00111111101111000001
100010111111100000000000000111111
11100000111111111111111111111111
1111111000000000C0000000000000E1
11111111111111111111111111111111
