11111111111
1P111111111
10C0C0C00E1
11111111111
