111111111111111111111111111111111111111111111
1111111111111111C0000011111111C11100000000C11
1P001000000C001111111011110000011101111101111
100010111111100000000000000111111101111101111
111000001111111111111111111111111101111101111
1110111000000000C00000000000C000000000C100001
1110111111111111111110111111111011101111111C1
1110000111C111000001101111C111101110111111111
111111011101110111011011110111101110000000001
1111110111011101C0011011110111101111111111101
100000011101110111111011110111101111111111101
101111111101110000000011110111101111111111101
100000000001111111111011110111101111111111101
11111111110111111111101111011110000000000C101
111111111101C000000000111101111011111111101C1
1C00000000C1111111111011110000001111111110101
111111111101111111111011111111111111111110101
11111111110111C000000000000000C11111111110101
1C000000000111111111111111111111111111111C1E1
111111111111111111111111111111111111111111111
