1111111111111111111111111111111111
1000000000000000000000000000E00001
1010010100100000101001000000010101
1010010010101010001001000C00010101
10000P0000001000000000000000000001
1111111111111111111111111111111111